Pigeon
Humming Bird
Pigeon
Sparrow
Map
00000000000000000000000000000000000000000000000
00000000000000000000000000000000000000000000000
00000000000000000000000000000000000000000000000
00000000000000000000000000000000000000000000000
00000000000000000000000000000000000000000000000
00000000000000000000000020302000000000000000000
00000000000000000000000022222000000000000000000
00000000000000000000000020000000000000003000000
00000000000000000000000020000000000000222220000
00000000000000000000000020000000000000002000000
00000000000000000022222220000003000000002000002
00000000000000000022222222222222222222222222222
00000000000000000000000000000000000000000000000
00000000000000000000000000000000000000000000000
00000000000000002222222002000020020020022222220
00000000000000000002000000200200020020000020000
00000000000000000002000000020000020020000020000
00000000000000000002000000020000020020000020000
00000000000000000002000000020000020020000020000
00000000000000000002000000020000022220000020000
11111111111111111111111111111111111111111111111
11111111111111111111111111111111111111111111111
