Pigeon
Humming Bird
Pigeon
Sparrow
Map
00000000000000000000000000000000000000000000000
00000000000000000000000000000000000000000000000
00000000000000000000000000000000000000000000000
00000000000000000000000000000000000000000000000
00000000000000000000000000000000000000000000000
00000000000000000000000000000000000000000000000
00000000000000000000000000000000000000000000000
00000000000000000000000000000000000000000000000
00000000000000000000000000000000000000000000000
00000000000000000000000000000000000000000000000
00000000000000000000000000000000000000000000000
00000000000000000000000000000000000000000000000
00000000000000000000000000200000000000000000000
00000000000000000000000000200000000000000000000
00000000000000000000000000200000000000000000000
00000000000000000000000000200000000020002000000
00000000000000000000000000200000000020002000000
00000000000000000000000000200000000020002000000
00000000000000000000000000200000000020302000000
00000000000000000000000000200000000022222000000
11111111111111111111111111111111111111111111111
11111111111111111111111111111111111111111111111
