Sparrow
Humming Bird
Pigeon
Pigeon
Humming Bird
Map
00000000000000000000000000000000000000000000000
00000000000000000000000000000000000000000000000
00000000000000000000000000000000000000000000000
00000000000000000000000000000000000000000000000
00000000000000000000000000000000000000000000000
00000000000000000000000000000000000000000000000
00000000000000000000000000000000000000000000000
00000000000000000000000000000000000000000000000
00000000000000000000000000000000000000000000000
00000000000000000000000000000000000000000000000
00000000000000000000000000000000000000000000000
00000000000000000000000000000000000000000000000
00000000000000000000002000300020000000000000000
000000000000000000000022222222200000000000000000
00000000000000000000000000200000000000000000000
00000000000000000000000000200000000000000000000
00000000000000000000000000200000000000000000000
00000000000000000000000000200000000000000000000
00000000000000000000000000200000000000000000000
00000000000000000000000000200000000000000000000
11111111111111111111111111111111111111111111111
11111111111111111111111111111111111111111111111